    sss = all
    ata = antiques
    ppa = appliances
    ara = arts+crafts
    sna = atvs/utvs/snow
    pta = auto parts
    baa = baby+kids
    bar = barter
    haa = beauty+hlth
    bip = bike parts
    bia = bikes
    bpa = boat parts
    boo = boats
    bka = books
    bfa = business
    cta = cars+trucks
    ema = cds/dvd/vhs
    moa = cell phones
    cla = clothes+acc
    cba = collectibles
    syp = computer parts
    sya = computers
    ela = electronics
    gra = farm+garden
    zip = free stuff
    fua = furniture
    gms = garage sales
    foa = general
    hva = heavy equipment
    hsa = household
    abo = housing
    jwa = jewelry
    maa = materials
    mpa = motorcycle parts
    mca = motorcycles
    msa = music instr
    pha = photo+video
    rva = RVs
    sga = sporting
    tia = tickets
    tla = tools
    taa = toys+games
    vga = video gaming
    waa = wanted
